##########
#u.......#
#........#
#........#
#........#
#........#
#......A.#
#........#
#........#
##########