####################
#.....#............#
#..u..#............#
#.....#.........#..#
#.....#............#
#.....#............#
###D###............#
#..................#
#..................#
#.........M........#
#..................#
#...........####D###
#...........#......#
#...........#......#
#...........#..d...#
#..#........#......#
#...........#......#
#...........#......#
####################